# Composites for BJCree project
# https://github.com/silnrsi/pysilfont/blob/master/docs/composite.md

### a-cans based
aa-cans         = a-cans + _dotabove@dot
wa-cans         = _dotleft & a-cans
waWestCree-cans = a-cans & _dotright
waa-cans        = wa-cans + _dotabove@dot
waaWestCree-cans = aa-cans & _dotright
waaNaskapi-cans = a-cans + _dotabove@dot2 + _dotabove@dot3
ayNaskapi-cans  = a-cans + _ring@ring
aayaNaskapi-cans = aa-cans + _ring@ringmiddle
wayNaskapi-cans = wa-cans + _ring@ring

### e-cans based
we-cans         = _dotleftclose & e-cans
weWestCree-cans = e-cans & _dotrightclose

### i-cans based
ii-cans         = i-cans + _dotabove@dot
wi-cans         = _dotleftclose & i-cans
wiWestCree-cans = i-cans & _dotrightclose
wii-cans        = wi-cans + _dotabove@dot
wiiWestCree-cans= ii-cans & _dotrightclose
aai-cans        = i-cans + _ring@ring

### o-cans based
oo-cans         = o-cans + _dotabove@dot
ooYCree-cans    = o-cans + _dot2hclose@2dotsmiddle
wo-cans         = _dotleft & o-cans
woWestCree-cans = o-cans & _dotright
woo-cans        = wo-cans + _dotabove@dot
wooWestCree-cans= oo-cans & _dotright
wooNaskapi-cans = o-cans + _dotabove@dot2 + _dotabove@dot3
oY-cans         = o-cans + _ring@ring

### pa-cans based
paa-cans        = pa-cans + _dotabove@dot
pwa-cans        = _dotleft & pa-cans
pwaWestCree-cans= pa-cans & _dotright
pwaa-cans       = pwa-cans + _dotabove@dot
pwaaWestCree-cans= paa-cans & _dotright
pwaYCree-cans   = pa-cans + _dotabove@dot2 + _dotabove@dot3
pay-cans        = pa-cans + _ring@ring

### pe-cans based
pwe-cans        = _dotleftclose & pe-cans
pweWestCree-cans= pe-cans & _dotrightclose

### pi-cans based
pii-cans        = pi-cans + _dotabove@dot
pwi-cans        = _dotleftclose & pi-cans
pwiWestCree-cans= pi-cans & _dotrightclose
pwii-cans       = pwi-cans + _dotabove@dot
pwiiWestCree-cans= pii-cans & _dotrightclose
paai-cans       = pi-cans + _ring@ring

### po-cans based
poo-cans        = po-cans + _dotabove@dot
pooYCree-cans   = po-cans + _dot2hclose@2dotsmiddle
pwo-cans        = _dotleft & po-cans
pwoWestCree-cans= po-cans & _dotright
pwoo-cans       = pwo-cans + _dotabove@dot
pwooWestCree-cans= poo-cans & _dotright
poy-cans        = po-cans + _ring@ring
pwoy-cans       = pwo-cans + _ring@ring

