# Composites for BJCree project
# https://github.com/silnrsi/pysilfont/blob/master/docs/composite.md

### ᐊ a-cans based
aa-cans             = a-cans + _dotabove@dot
wa-cans             = _dotleft & a-cans
waWestCree-cans     = a-cans & _dotright
waa-cans            = wa-cans + _dotabove@dot
waaWestCree-cans    = aa-cans & _dotright
waaNaskapi-cans     = a-cans + _dotabove@dot2 + _dotabove@dot3
ayNaskapi-cans      = a-cans + _ring@ring
aayaNaskapi-cans    = aa-cans + _ring@ringmiddle
wayNaskapi-cans     = wa-cans + _ring@ring

### ᐁ e-cans based
we-cans             = _dotleftclose & e-cans
weWestCree-cans     = e-cans & _dotrightclose

### ᐃ i-cans based
ii-cans             = i-cans + _dotabove@dot
wi-cans             = _dotleftclose & i-cans
wiWestCree-cans     = i-cans & _dotrightclose
wii-cans            = wi-cans + _dotabove@dot
wiiWestCree-cans    = ii-cans & _dotrightclose
aai-cans            = i-cans + _ring@ring

### ᐅ o-cans based
oo-cans             = o-cans + _dotabove@dot
ooYCree-cans        = o-cans + _dot2hclose@2dotsmiddle
wo-cans             = _dotleft & o-cans
woWestCree-cans     = o-cans & _dotright
woo-cans            = wo-cans + _dotabove@dot
wooWestCree-cans    = oo-cans & _dotright
wooNaskapi-cans     = o-cans + _dotabove@dot2 + _dotabove@dot3
oY-cans             = o-cans + _ring@ring

### ᐸ pa-cans based
paa-cans            = pa-cans + _dotabove@dot
pwa-cans            = _dotleft & pa-cans
pwaWestCree-cans    = pa-cans & _dotright
pwaa-cans           = pwa-cans + _dotabove@dot
pwaaWestCree-cans   = paa-cans & _dotright
pwaYCree-cans       = pa-cans + _dotabove@dot2 + _dotabove@dot3
pay-cans            = pa-cans + _ring@ring

### ᐯ pe-cans based
pwe-cans            = _dotleftclose & pe-cans
pweWestCree-cans    = pe-cans & _dotrightclose

### ᐱ pi-cans based
pii-cans            = pi-cans + _dotabove@dot
pwi-cans            = _dotleftclose & pi-cans
pwiWestCree-cans    = pi-cans & _dotrightclose
pwii-cans           = pwi-cans + _dotabove@dot
pwiiWestCree-cans   = pii-cans & _dotrightclose
paai-cans           = pi-cans + _ring@ring

### ᐳ po-cans based
poo-cans            = po-cans + _dotabove@dot
pooYCree-cans       = po-cans + _dot2hclose@2dotsmiddle
pwo-cans            = _dotleft & po-cans
pwoWestCree-cans    = po-cans & _dotright
pwoo-cans           = pwo-cans + _dotabove@dot
pwooWestCree-cans   = poo-cans & _dotright
poy-cans            = po-cans + _ring@ring
pwoy-cans           = pwo-cans + _ring@ring

### ᑕ ta-cans based
taa-cans            = ta-cans + _dotabove@dot
twa-cans            = _dotleft & ta-cans
twaWestCree-cans    = ta-cans & _dotright
twaa-cans           = twa-cans + _dotabove@dot
twaaWestCree-cans   = taa-cans & _dotright
twaaNaskapi-cans    = _dot2vclose & ta-cans
tay-cans            = ta-cans + _ring@ring

### ᑌ te-cans based
twe-cans            = _dotleft & te-cans
tweWestCree-cans    = te-cans & _dotright

### ᑎ ti-cans based
tii-cans            = ti-cans + _dotabove@dot
twi-cans            = _dotleft & ti-cans
twiWestCree-cans    = ti-cans & _dotright
twii-cans           = twi-cans + _dotabove@dot
twiiWestCree-cans   = tii-cans & _dotright
taai-cans           = ti-cans + _ring@ring

### ᑐ to-cans
too-cans            = to-cans + _dotabove@dot
tooYCree-cans       = to-cans + _dot2hclose@2dotsleft
two-cans            = _dotleft & to-cans
twoWestCree-cans    = to-cans & _dotright
twoo-cans           = two-cans + _dotabove@dot
twooWestCree-cans  = too-cans & _dotright

### ᑲ ka-cans based
kaa-cans            = ka-cans + _dotabove@dot
kwa-cans            = _dotleft & ka-cans
kwaWestCree-cans    = ka-cans & _dotright
kwaa-cans           = kwa-cans + _dotabove@dot
kwaaWestCree-cans   = kaa-cans & _dotright
kwaaNaskapi-cans    = _dot2v & ka-cans
kayNaskapi-cans     = ka-cans + _ring@ring
kwayNaskapi-cans    = kwa-cans + _ring@ring

### ᑫ ke-cans based
kwe-cans            = _dotleft & ke-cans
kweWestCree-cans    = ke-cans & _dotright

### ᑭ ki-cans based
kii-cans            = ki-cans + _dotabove@dot
kwi-cans            = _dotleft & ki-cans
kwiWestCree-cans    = ki-cans & _dotright
kwii-cans           = kwi-cans + _dotabove@dot
kwiiWestCree-cans   = kii-cans & _dotright
kaai-cans           = ki-cans + _ring@ring

### ᑯ ko-cans
koo-cans            = ko-cans + _dotabove@dot
kooYCree-cans       = ko-cans + _dot2hclose@2dotsright
kwo-cans            = _dotleft & ko-cans
kwoWestCree-cans    = ko-cans & _dotright
kwoo-cans           = kwo-cans + _dotabove@dot
kwooWestCree-cans   = koo-cans & _dotright

### ᓇ na-cans based
naa-cans            = na-cans + _dotabove@dot
nwa-cans            = _dotleft & na-cans
nwaWestCree-cans    = na-cans & _dotrightcloser
nwaa-cans           = nwa-cans + _dotabove@dot
nwaaWestCree-cans   = naa-cans & _dotrightcloser
nwaaNaskapi-cans    = nwa-cans + _dot2hclose@2dotsmiddle
nay-cans            = na-cans + _ring@ring

### ᓀ ne-cans based
nwe-cans            = _dotleft & ne-cans
nweWestCree-cans    = ne-cans & _dotright

### ᓂ ni-cans based
nii-cans            = ni-cans + _dotabove@dot
nwi-cans            = _dotleft & ni-cans
nwiOjibway-cans     = ni-cans & _dotright
nwii-cans           = nwi-cans + _dotabove@dot
nwiiOjibway-cans    = nii-cans & _dotright
naai-cans           = ni-cans + _ring@ring

### ᓄ no-cans based
noo-cans            = no-cans + _dotabove@dot
nooYCree-cans       = no-cans + _dot2hclose@2dotsmiddle
nwo-cans            = _dotleftcloser & no-cans
nwoOjibway-cans     = no-cans & _dotright
nwoo-cans           = nwo-cans + _dotabove@dot
nwooOjibway-cans    = noo-cans & _dotright
noy-cans            = no-cans + _ring@ring

### ᒐ ca-cans based
caa-cans            = ca-cans + _dotabove@dot
cwa-cans            = _dotleft & ca-cans
cwaWestCree-cans    = ca-cans & _dotright
cwaa-cans           = _dotleft & caa-cans
cwaaWestCree-cans   = caa-cans & _dotright
cwaaNaskapi-cans    = _dot2v & ca-cans
scwaNaskapi-cans    = _dot2vsa & ca-cans

### ᒉ ce-cans based
cwe-cans            = _dotleft & ce-cans
cweWestCree-cans    = ce-cans & _dotright

### ᒋ ci-cans based
cii-cans            = ci-cans + _dotabove@dot
cwi-cans            = _dotleft & ci-cans
cwiWestCree-cans    = ci-cans & _dotright
cwii-cans           = cwi-cans + _dotabove@dot
cwiiWestCree-cans   = cii-cans & _dotright
caai-cans           = ci-cans + _ring@ring

### ᒍ co-cans based
coo-cans            = co-cans + _dotabove@dot
cooYCree-cans       = co-cans + _dot2hclose@2dotsright
cwo-cans            = _dotleft & co-cans
cwoWestCree-cans    = co-cans & _dotright
cwoo-cans           = cwo-cans + _dotabove@dot
cwooWestCree-cans   = coo-cans & _dotright

### ᓚ la-cans based
laa-cans            = la-cans + _dotabove@dot
lwa-cans            = _dotleft & la-cans
lwaWestCree-cans    = la-cans & _dotrightcloser
lwaa-cans           = lwa-cans + _dotabove@dot
lwaaWestCree-cans   = laa-cans & _dotrightcloser
layWestCree-cans    = la-cans + _ring@ring

### ᓓ le-cans based
lwe-cans            = _dotleft & le-cans
lweWestCree-cans    = le-cans & _dotright

### ᓕ li-cans based
lii-cans            = li-cans + _dotabove@dot
lwi-cans            = _dotleft & li-cans
lwiWestCree-cans    = li-cans & _dotright
lwii-cans           = lwi-cans + _dotabove@dot
lwiiWestCree-cans   = lii-cans & _dotright
laai-cans           = li-cans + _ring@ring

### ᓗ lo-cans based
loo-cans            = lo-cans + _dotabove@dot
looYCree-cans       = lo-cans + _dot2hclose@2dotsmiddle
lwo-cans            = _dotleftcloser & lo-cans
lwoWestCree-cans    = lo-cans & _dotright
lwoo-cans           = lwo-cans + _dotabove@dot
lwooWestCree-cans   = loo-cans & _dotright

### ᒪ ma-cans based
maa-cans            = ma-cans + _dotabove@dot
mwa-cans            = _dotleft & ma-cans
mwaWestCree-cans    = ma-cans & _dotrightclose
mwaa-cans           = mwa-cans + _dotabove@dot
mwaaWestCree-cans   = maa-cans & _dotrightclose
mwaaNaskapi-cans    = _dot2v & ma-cans
mayNaskapi-cans     = ma-cans + _ring@ring

### ᒣ me-cans based
mwe-cans            = _dotleft & me-cans
mweWestCree-cans    = me-cans & _dotright

### ᒥ mi-cans based
mii-cans            = mi-cans + _dotabove@dot
mwi-cans            = _dotleft & mi-cans
mwiWestCree-cans    = mi-cans & _dotright
mwii-cans           = mwi-cans + _dotabove@dot
mwiiWestCree-cans   = mii-cans & _dotright
maai-cans           = mi-cans + _ring@ring

### ᒧ mo-cans based
moo-cans            = mo-cans + _dotabove@dot
mooYCree-cans       = mo-cans + _dot2hclose@2dotsright
mwo-cans            = _dotleftcloser & mo-cans
mwoWestCree-cans    = mo-cans & _dotright
mwoo-cans           = mwo-cans + _dotabove@dot
mwooWestCree-cans   = moo-cans & _dotright

### ᓴ sa-cans based
saa-cans            = sa-cans + _dotabove@dot
swa-cans            = _dotleft & sa-cans
swaWestCree-cans    = sa-cans & _dotright
swaa-cans           = swa-cans + _dotabove@dot
swaaWestCree-cans   = saa-cans & _dotright
swaaNaskapi-cans    = swa-cans & _dot2vclose
say-cans            = sa-cans + _ring@ring

### ᓭ se-cans based
swe-cans            = _dotleft & se-cans
sweWestCree-cans    = se-cans & _dotright

### ᓯ si-cans based
sii-cans            = si-cans + _dotabove@dot
swi-cans            = _dotleft & si-cans
swiWestCree-cans    = si-cans & _dotrightclose
swii-cans           = swi-cans + _dotabove@dot
swiiWestCree-cans   = sii-cans & _dotrightclose
saai-cans           = si-cans + _ring@ring

### ᓱ so-cans based
soo-cans            = so-cans + _dotabove@dot
sooYCree-cans       = so-cans + _dot2hclose@2dotsright
swo-cans            = _dotleftclose & so-cans
swoWestCree-cans    = so-cans & _dotright
swoo-cans           = swo-cans + _dotabove@dot
swooWestCree-cans   = soo-cans & _dotright
soy-cans            = so-cans + _ring@ring

### ᔕ sha-cans based
shaa-cans           = sha-cans + _dotabove@dot
shwa-cans           = _dotleft & sha-cans
shwaWestCree-cans   = sha-cans & _dotright
shwaa-cans          = shwa-cans + _dotabove@dot
shwaaWestCree-cans  = shaa-cans & _dotright
shay-cans           = sha-cans + _ring@ring

### ᔐ she-cans based
shwe-cans           = _dotleft & she-cans
shweWestCree-cans   = she-cans & _dotright

### ᔑ shi-cans based
shii-cans           = shi-cans + _dotabove@dot
shwi-cans           = _dotleft & shi-cans
shwiWestCree-cans   = shi-cans & _dotright
shwii-cans          = shwi-cans + _dotabove@dot
shwiiWestCree-cans  = shii-cans & _dotright

### ᔓ sho-cans based
shoo-cans           = sho-cans + _dotabove@dot
shwo-cans           = _dotleft & sho-cans
shwoWestCree-cans   = sho-cans & _dotright
shwoo-cans          = shwo-cans + _dotabove@dot
shwooWestCree-cans  = shoo-cans & _dotright
shoy-cans           = sho-cans + _ring@ring
shwoy-cans          = shwo-cans + _ring@ring

### ᔭ ya-cans based
yaa-cans            = ya-cans + _dotabove@dot
ywa-cans            = _dotleft & ya-cans
ywaWestCree-cans    = ya-cans & _dotright
ywaa-cans           = ywa-cans + _dotabove@dot
ywaaWestCree-cans   = yaa-cans & _dotright
ywaaNaskapi-cans    = _dot2v & ya-cans
yay-cans            = ya-cans + _ring@ring

### ᖬ thaThCree-cans based
thaaThCree-cans     = thaThCree-cans + _dotabove@dot
thwaWoodsCree-cans  = thaThCree-cans & _dotright
thwaaWoodsCree-cans = thwaWoodsCree-cans + _dotabove@dot

### ᔦ ye-cans based
ywe-cans            = _dotleft & ye-cans
yweWestCree-cans    = ye-cans & _dotright

### ᖧ theThCree-cans based
thweeWoodsCree-cans = theThCree-cans & _dotright

### ᔨ yi-cans based
yii-cans            = yi-cans + _dotabove@dot
ywi-cans            = _dotleft & yi-cans
ywiWestCree-cans    = yi-cans & _dotright
ywii-cans           = ywi-cans + _dotabove@dot
ywiiWestCree-cans   = yii-cans & _dotright
yaai-cans           = yi-cans + _ring@ring

### ᖨ thiThCree-cans based
thiiThCree-cans     = thiThCree-cans + _dotabove@dot
thwiWoodsCree-cans  = thiThCree-cans & _dotright
thwiiWoodsCree-cans = thwiWoodsCree-cans + _dotabove@dot

### ᔪ yo-cans based
yoo-cans            = yo-cans + _dotabove@dot
yooYCree-cans       = yo-cans + _dot2hclose@2dotsright
ywo-cans            = _dotleft & yo-cans
ywoWestCree-cans    = yo-cans & _dotright
ywoo-cans           = ywo-cans + _dotabove@dot
ywooWestCree-cans   = yoo-cans & _dotright
yoy-cans            = yo-cans + _ring@ring

### ᖪ thoThCree-cans based
thooThCree-cans     = thoThCree-cans + _dotabove@dot
thwoWoodsCree-cans  = thoThCree-cans & _dotright
thwooWoodsCree-cans = thwoWoodsCree-cans + _dotabove@dot

### ᕋ ra-cans based
raa-cans            = ra-cans + _dotabove@dot
rwa-cans            = _dotleft & ra-cans
rwaa-cans           = rwa-cans + _dotabove@dot
rwaaWestCree-cans   = raa-cans & _dotright
ray-cans            = ra-cans + _ring@ring

### ᕂ re-cans based
# None

### ᕃ reRCree-cans based
rwee-cans           = _dotleft & reRCree-cans
rweRCree-cans       = reRCree-cans & _dotright

### ᕄ leWestCree-cans based
# None

### ᕆ ri-cans based
rii-cans            = ri-cans + _dotabove@dot
rwi-cans            = _dotleft & ri-cans
rwii-cans           = rwi-cans + _dotabove@dot
raai-cans           = ri-cans + _ring@ring

### ᕈ ro-cans based
roo-cans            = ro-cans + _dotabove@dot
rwo-cans            = _dotleft & ro-cans
rwoo-cans           = rwo-cans + _dotabove@dot

### ᕊ loWestCree-cans based
looWestCree-cans    = loWestCree-cans + _dotabove@dot

### ᕍ laWestCree-cans based
laaWestCree-cans    = laWestCree-cans + _dotabove@dot

### ᕙ fa-cans based
faa-cans            = fa-cans + _dotabove@dot
fwaa-cans           = _dotleft & faa-cans
fwaaWestCree-cans   = faa-cans & _dotright

### ᕓ fe-cans based
# None

### ᕕ fi-cans based
fii-cans            = fi-cans + _dotabove@dot
faai-cans           = fi-cans + _ring@ring

### ᕗ fo-cans based
foo-cans            = fo-cans + _dotabove@dot

### ᕦ tha-cans based
thaa-cans           = tha-cans + _dotabove@dot
thwa-cans           = tha-cans & _dotrightclose
thwaa-cans          = _dotleft & thaa-cans
thwaaWestCree-cans  = thaa-cans & _dotrightclose

### ᕞ the-cans based
thwe-cans           = the-cans & _dotright

### ᕟ theNCree-cans based
# None

### ᕠ thi-cans based
thii-cans           = thi-cans + _dotabove@dot

### ᕡ thiNCree-cans based
thiiNCree-cans      = thiNCree-cans + _dotabove@dot

### ᕤ tho-cans based
thoo-cans           = tho-cans + _dotabove@dot
